"TailNum,""totalDistance"""
"N543UA,""7675"""
"N12238,""6829"""
"N580JB,""6277"""
"N5DCAA,""5300"""
"N637DL,""5223"""
"N5DJAA,""5046"""
"N653UA,""5005"""
"N614UA,""4950"""
"N615DL,""4948"""
"N128DL,""4584"""
